{ 
	"tile":[
		[1, 1, 1, 1, 1,14,13, 1, 1, 1,14,11,11,11,13, 1, 1, 1,14,13, 1, 1, 1, 1, 1],
		[1, 1, 1,14,11,12,10,11,13, 1,16, 9, 7, 8,15, 1,14,11,12,10,11,13, 1, 1, 1],
		[1, 1,14,12, 0, 0, 0, 0,10,13, 2, 6,10,13, 2,14,12, 0, 0, 0, 0,10,13, 1, 1],
		[1, 1,16, 8, 8, 8, 9, 7, 8,15, 1, 6, 0, 5, 1,16, 8, 8, 8, 8, 8, 9, 5, 1, 1],
		[1,14,11,11,11,11,12,10,11,11,13, 4, 0, 3,14,11,11,11,11,13,14,12,10,13, 1],
		[1, 6, 0, 0, 0, 0, 0, 0, 0, 0,10,12, 0,10,12, 7, 8, 8, 9, 5,16, 8, 9, 5, 1],
		[1,16, 8, 9, 0, 0, 0, 0, 0, 0, 7, 9, 0, 0, 0,10,13,14,12,10,11,11,12, 5, 1],
		[1, 2, 1,16, 8, 8, 8, 9, 0, 0, 5, 6, 0, 0, 0, 0, 3,16, 8, 8, 8, 8, 9, 5, 1],
		[1,14,11,11,11,11,11,12, 0, 0, 5,16, 9, 0, 0, 0, 5,14,11,11,13, 2, 6, 5, 1],
		[1, 6, 7, 8, 8, 8, 8, 8, 9, 7,15, 2,16, 9, 0, 0, 5, 6, 7, 8,15, 2, 6, 5, 1],
		[1, 6,10,11,13, 1,14,11,12,10,11,13, 1,16, 9, 7,15, 6,10,11,13, 2, 6, 5, 1],
		[1, 6, 0, 0, 5, 2, 6, 0, 0, 0, 0, 5, 1,14,12,10,13, 4, 0, 0, 5, 2, 6, 5, 1],
		[1, 4, 0, 0, 5, 1, 6, 0, 0, 0, 0, 5, 1, 6, 0, 0,10,12, 0, 0, 5, 2, 6, 5, 1],
		[2,16, 8, 8,15, 2,16, 8, 8, 8, 8,15, 1,16, 8, 8, 8, 8, 8, 8,15, 2,16,15, 2],
		[1, 1, 2, 1, 2, 1, 2, 1, 2, 1, 2, 1, 2, 1, 2, 1, 2, 1, 2, 1, 2, 1, 2, 1, 1]
	]
}